5
3 6 -5
1 5 -1
6 5 -2
7 5 -4
7 3 0
xxxxxxxxxxxx
     +     x
x    s     x
x     +    x
x          x
x          x
x    +     x
x    +     x
x          x
xxxxxxxxxxxx
